filename,dyadNumber,condition,game,trial,target,choice,correct,signallingPlayer,role,turnNumber,turnType,turnStart,turnEnd,turnLength,modality,signalStart,signalEnd,signalLength,signalType
D16_TT_Coded.eaf,D16,Auditory,0,2,3,3,Correct,1,Director,1,"T1",247510,250910,3400,Acoustic,247510,250910,3400,"X"
D16_TT_Coded.eaf,D16,Auditory,0,3,8,8,Correct,2,Director,1,"T1",277690,280310,2620,Acoustic,277690,280310,2620,"X"
D16_TT_Coded.eaf,D16,Auditory,0,4,5,5,Correct,1,Director,1,"T1",324300,324900,600,Acoustic,324300,324900,600,"X"
D16_TT_Coded.eaf,D16,Auditory,0,5,4,7,Incorrect,2,Director,1,"T1",339090,339600,510,Acoustic,339090,339600,510,"X"
D16_TT_Coded.eaf,D16,Auditory,0,6,6,2,Incorrect,1,Director,1,"T1",360905,363195,2290,Acoustic,360905,363195,2290,"X"
D16_TT_Coded.eaf,D16,Auditory,0,7,2,2,Correct,2,Director,1,"T1",384510,386500,1990,Acoustic,384510,386500,1990,"X"
D16_TT_Coded.eaf,D16,Auditory,0,8,1,1,Correct,1,Director,1,"T1",427520,430300,2780,Acoustic,427520,430300,2780,"X"
D16_TT_Coded.eaf,D16,Auditory,0,9,5,5,Correct,2,Director,1,"T1",448510,449010,500,Acoustic,448510,449010,500,"X"
D16_TT_Coded.eaf,D16,Auditory,0,10,2,1,Incorrect,1,Director,1,"T1",484630,487410,2780,Acoustic,484630,487410,2780,"X"
D16_TT_Coded.eaf,D16,Auditory,0,11,3,8,Incorrect,2,Director,1,"T1",513110,516900,3790,Acoustic,513110,516900,3790,"X"
D16_TT_Coded.eaf,D16,Auditory,0,12,8,8,Correct,1,Director,1,"T1",546610,548910,2300,Acoustic,546610,548910,2300,"X"
D16_TT_Coded.eaf,D16,Auditory,0,13,6,8,Incorrect,2,Director,1,"T1",558400,561290,2890,Acoustic,558400,561290,2890,"X"
D16_TT_Coded.eaf,D16,Auditory,0,14,4,4,Correct,1,Director,1,"T1",577200,577800,600,Acoustic,577200,577800,600,"X"
D16_TT_Coded.eaf,D16,Auditory,0,15,7,8,Incorrect,2,Director,1,"T1",596800,599600,2800,Acoustic,596800,599600,2800,"X"
D16_TT_Coded.eaf,D16,Auditory,1,0,8,8,Correct,1,Director,1,"T1",655000,657100,2100,Acoustic,655000,657100,2100,"X"
D16_TT_Coded.eaf,D16,Auditory,1,1,6,8,Incorrect,2,Director,1,"T1",664600,667610,3010,Acoustic,664600,667610,3010,"X"
D16_TT_Coded.eaf,D16,Auditory,1,2,5,5,Correct,1,Director,1,"T1",678695,679615,920,Acoustic,678695,679615,920,"X"
D16_TT_Coded.eaf,D16,Auditory,1,3,4,4,Correct,2,Director,1,"T1",689890,690300,410,Acoustic,689890,690300,410,"X"
D16_TT_Coded.eaf,D16,Auditory,1,4,2,1,Incorrect,1,Director,1,"T1",707510,710610,3100,Acoustic,707510,710610,3100,"X"
D16_TT_Coded.eaf,D16,Auditory,1,5,3,3,Correct,2,Director,1,"T1",736300,739610,3310,Acoustic,736300,739610,3310,"X"
D16_TT_Coded.eaf,D16,Auditory,1,6,6,2,Incorrect,1,Director,1,"T1",765200,767300,2100,Acoustic,765200,767300,2100,"X"
D16_TT_Coded.eaf,D16,Auditory,1,7,2,2,Correct,2,Director,1,"T1",785710,787500,1790,Acoustic,785710,787500,1790,"X"
D16_TT_Coded.eaf,D16,Auditory,1,8,4,4,Correct,1,Director,1,"T1",808300,808900,600,Acoustic,808300,808900,600,"X"
D16_TT_Coded.eaf,D16,Auditory,1,9,7,7,Correct,2,Director,1,"T1",822300,825810,3510,Acoustic,822300,825810,3510,"X"
D16_TT_Coded.eaf,D16,Auditory,1,10,3,3,Correct,1,Director,1,"T1",846900,850500,3600,Acoustic,846900,850500,3600,"X"
D16_TT_Coded.eaf,D16,Auditory,1,11,8,8,Correct,2,Director,1,"T1",867710,870010,2300,Acoustic,867710,870010,2300,"X"
D16_TT_Coded.eaf,D16,Auditory,1,12,1,1,Correct,1,Director,1,"T1",882610,885700,3090,Acoustic,882610,885700,3090,"X"
D16_TT_Coded.eaf,D16,Auditory,1,13,5,5,Correct,1,Matcher,1,"T1",900800,901610,810,Acoustic,900800,901610,810,"X"
D16_TT_Coded.eaf,D16,Auditory,1,14,7,7,Correct,1,Director,1,"T1",925110,928120,3010,Acoustic,925110,928120,3010,"X"
D16_TT_Coded.eaf,D16,Auditory,1,15,1,1,Correct,2,Director,1,"T1",945990,945995,5,Acoustic,945990,945995,5,"X"
D16_TT_Coded.eaf,D16,Auditory,1,15,1,1,Correct,2,Director,2,"T1",945995,948195,2200,Acoustic,945990,945995,5,"X"
D16_TT_Coded.eaf,D16,Auditory,1,15,1,1,Correct,2,Director,1,"T1",945990,945995,5,Acoustic,945995,948195,2200,"X"
D16_TT_Coded.eaf,D16,Auditory,1,15,1,1,Correct,2,Director,2,"T1",945995,948195,2200,Acoustic,945995,948195,2200,"X"
D16_TT_Coded.eaf,D16,Auditory,2,0,3,3,Correct,1,Director,1,"T1",980700,984400,3700,Acoustic,980700,984400,3700,"X"
D16_TT_Coded.eaf,D16,Auditory,2,1,8,8,Correct,2,Director,1,"T1",996510,999610,3100,Acoustic,996510,999610,3100,"X"
D16_TT_Coded.eaf,D16,Auditory,2,2,4,4,Correct,1,Director,1,"T1",1010600,1011110,510,Acoustic,1010600,1011110,510,"X"
D16_TT_Coded.eaf,D16,Auditory,2,3,7,7,Correct,2,Director,1,"T1",1021200,1024000,2800,Acoustic,1021200,1024000,2800,"X"
D16_TT_Coded.eaf,D16,Auditory,2,4,6,2,Incorrect,1,Director,1,"T1",1037190,1039800,2610,Acoustic,1037190,1039800,2610,"X"
D16_TT_Coded.eaf,D16,Auditory,2,5,2,2,Correct,2,Director,1,"T1",1052790,1055300,2510,Acoustic,1052790,1055300,2510,"X"
D16_TT_Coded.eaf,D16,Auditory,2,6,8,8,Correct,1,Director,1,"T1",1072300,1075000,2700,Acoustic,1072300,1075000,2700,"X"
D16_TT_Coded.eaf,D16,Auditory,2,7,3,3,Correct,2,Director,1,"T1",1089690,1093400,3710,Acoustic,1089690,1093400,3710,"X"
D16_TT_Coded.eaf,D16,Auditory,2,8,2,5,Incorrect,1,Director,1,"T1",1111900,1116010,4110,Acoustic,1111900,1116010,4110,"X"
D16_TT_Coded.eaf,D16,Auditory,2,9,6,6,Correct,2,Director,1,"T1",1131710,1135200,3490,Acoustic,1131710,1135200,3490,"X"
D16_TT_Coded.eaf,D16,Auditory,2,10,5,5,Correct,1,Director,1,"T1",1152110,1153010,900,Acoustic,1152110,1153010,900,"X"
D16_TT_Coded.eaf,D16,Auditory,2,11,4,4,Correct,2,Director,1,"T1",1161100,1161710,610,Acoustic,1161100,1161710,610,"X"
D16_TT_Coded.eaf,D16,Auditory,2,10,5,5,Correct,2,Matcher,1,"T1",1161100,1161710,610,Acoustic,1161100,1161710,610,"X"
D16_TT_Coded.eaf,D16,Auditory,2,12,1,1,Correct,1,Director,1,"T1",1171600,1174400,2800,Acoustic,1171600,1174400,2800,"X"
D16_TT_Coded.eaf,D16,Auditory,2,13,5,5,Correct,2,Director,1,"T1",1183510,1184000,490,Acoustic,1183510,1184000,490,"X"
D16_TT_Coded.eaf,D16,Auditory,2,14,7,7,Correct,1,Director,1,"T1",1204100,1206900,2800,Acoustic,1204100,1206900,2800,"X"
D16_TT_Coded.eaf,D16,Auditory,2,15,1,1,Correct,2,Director,1,"T1",1216990,1219510,2520,Acoustic,1216990,1219510,2520,"X"
D16_TT_Coded.eaf,D16,Auditory,3,0,2,2,Correct,1,Director,1,"T1",1246200,1250400,4200,Acoustic,1246200,1250400,4200,"X"
D16_TT_Coded.eaf,D16,Auditory,3,1,3,3,Correct,2,Director,1,"T1",1270300,1274100,3800,Acoustic,1270300,1274100,3800,"X"
D16_TT_Coded.eaf,D16,Auditory,3,2,7,7,Correct,1,Director,1,"T1",1289900,1293090,3190,Acoustic,1289900,1293090,3190,"X"
D16_TT_Coded.eaf,D16,Auditory,3,3,1,1,Correct,2,Director,1,"T1",1300800,1303100,2300,Acoustic,1300800,1303100,2300,"X"
D16_TT_Coded.eaf,D16,Auditory,3,4,5,5,Correct,1,Director,1,"T1",1315600,1316500,900,Acoustic,1315600,1316500,900,"X"
D16_TT_Coded.eaf,D16,Auditory,3,5,4,4,Correct,2,Director,1,"T1",1323700,1324300,600,Acoustic,1323700,1324300,600,"X"
D16_TT_Coded.eaf,D16,Auditory,3,6,3,3,Correct,1,Director,1,"T1",1344610,1348100,3490,Acoustic,1344610,1348100,3490,"X"
D16_TT_Coded.eaf,D16,Auditory,3,7,8,8,Correct,2,Director,1,"T1",1354600,1357500,2900,Acoustic,1354600,1357500,2900,"X"
D16_TT_Coded.eaf,D16,Auditory,3,8,6,6,Correct,1,Director,1,"T1",1367610,1369900,2290,Acoustic,1367610,1369900,2290,"X"
D16_TT_Coded.eaf,D16,Auditory,3,8,6,6,Correct,2,Matcher,1,"T1",1387710,1390100,2390,Acoustic,1387710,1390100,2390,"X"
D16_TT_Coded.eaf,D16,Auditory,3,10,4,4,Correct,1,Director,1,"T1",1416000,1416390,390,Acoustic,1416000,1416390,390,"X"
D16_TT_Coded.eaf,D16,Auditory,3,11,7,7,Correct,2,Director,1,"T1",1426210,1429210,3000,Acoustic,1426210,1429210,3000,"X"
D16_TT_Coded.eaf,D16,Auditory,3,12,8,8,Correct,1,Director,1,"T1",1449190,1452000,2810,Acoustic,1449190,1452000,2810,"X"
D16_TT_Coded.eaf,D16,Auditory,3,13,6,6,Correct,2,Director,1,"T1",1456000,1459290,3290,Acoustic,1456000,1459290,3290,"X"
D16_TT_Coded.eaf,D16,Auditory,3,14,1,1,Correct,1,Director,1,"T1",1471990,1474900,2910,Acoustic,1471990,1474900,2910,"X"
D16_TT_Coded.eaf,D16,Auditory,3,14,1,1,Correct,2,Matcher,1,"T1",1480220,1480790,570,Acoustic,1480220,1480790,570,"X"
D16_TT_Coded.eaf,D16,Auditory,0,0,3,5,Incorrect,1,Director,1,"T1",1648000,1651900,3900,Acoustic,1648000,1651900,3900,"X"
D16_TT_Coded.eaf,D16,Visual,0,1,8,3,Incorrect,2,Director,1,"T1",1693205,1717200,23995,Acoustic,1693210,1695090,1880,"X"
D16_TT_Coded.eaf,D16,Auditory,0,0,3,5,Incorrect,2,Matcher,1,"T1",1693205,1717200,23995,Acoustic,1693210,1695090,1880,"X"
D16_TT_Coded.eaf,D16,Visual,0,1,8,3,Incorrect,2,Director,1,"T1",1693205,1717200,23995,Acoustic,1715100,1717200,2100,"X"
D16_TT_Coded.eaf,D16,Auditory,0,0,3,5,Incorrect,2,Matcher,1,"T1",1693205,1717200,23995,Acoustic,1715100,1717200,2100,"X"
D16_TT_Coded.eaf,D16,Visual,0,2,4,4,Correct,1,Director,1,"T1",1758300,1761210,2910,Acoustic,1758300,1761210,2910,"X"
D16_TT_Coded.eaf,D16,Visual,0,3,7,3,Incorrect,2,Director,1,"T1",1779400,1780600,1200,Acoustic,1779400,1780600,1200,"X"
D16_TT_Coded.eaf,D16,Visual,0,4,6,8,Incorrect,1,Director,1,"T1",1818790,1822700,3910,Acoustic,1818790,1822700,3910,"X"
D16_TT_Coded.eaf,D16,Visual,0,5,2,2,Correct,2,Director,1,"T1",1828100,1830600,2500,Acoustic,1828100,1830600,2500,"X"
D16_TT_Coded.eaf,D16,Visual,0,4,6,8,Incorrect,2,Matcher,1,"T1",1828100,1830600,2500,Acoustic,1828100,1830600,2500,"X"
D16_TT_Coded.eaf,D16,Visual,0,6,8,1,Incorrect,1,Director,1,"T1",1871990,1875500,3510,Acoustic,1871990,1875500,3510,"X"
D16_TT_Coded.eaf,D16,Visual,0,7,3,4,Incorrect,2,Director,1,"T1",1885200,1888740,3540,Acoustic,1885200,1888740,3540,"X"
D16_TT_Coded.eaf,D16,Visual,0,8,2,2,Correct,1,Director,1,"T1",1905510,1909110,3600,Acoustic,1905510,1909110,3600,"X"
D16_TT_Coded.eaf,D16,Visual,0,9,6,6,Correct,2,Director,1,"T1",1915400,1918800,3400,Acoustic,1915400,1918800,3400,"X"
D16_TT_Coded.eaf,D16,Visual,0,10,5,7,Incorrect,1,Director,1,"T1",1930800,1938010,7210,Acoustic,1930790,1932790,2000,"X"
D16_TT_Coded.eaf,D16,Visual,0,10,5,7,Incorrect,1,Director,1,"T1",1930800,1938010,7210,Acoustic,1933100,1935280,2180,"X"
D16_TT_Coded.eaf,D16,Visual,0,10,5,7,Incorrect,1,Director,1,"T1",1930800,1938010,7210,Acoustic,1936010,1938010,2000,"X"
D16_TT_Coded.eaf,D16,Visual,0,10,5,7,Incorrect,2,Matcher,1,"T1",1952700,1955690,2990,Acoustic,1952700,1955690,2990,"X"
D16_TT_Coded.eaf,D16,Visual,0,11,4,7,Incorrect,2,Director,1,"T1",1969010,1974300,5290,Acoustic,1969010,1974300,5290,"X"
D16_TT_Coded.eaf,D16,Visual,0,12,1,7,Incorrect,1,Director,1,"T1",1999300,2003020,3720,Acoustic,1999300,2003020,3720,"X"
D16_TT_Coded.eaf,D16,Visual,0,13,5,5,Correct,2,Director,1,"T1",2011200,2014300,3100,Acoustic,2011200,2014300,3100,"X"
D16_TT_Coded.eaf,D16,Visual,0,14,7,7,Correct,1,Director,1,"T1",2023690,2026300,2610,Acoustic,2023690,2026300,2610,"X"
D16_TT_Coded.eaf,D16,Visual,0,15,1,6,Incorrect,2,Director,1,"T1",2029790,2032390,2600,Acoustic,2029790,2032390,2600,"X"
D16_TT_Coded.eaf,D16,Visual,1,0,2,2,Correct,1,Director,1,"T1",2043300,2046090,2790,Acoustic,2043300,2046090,2790,"X"
D16_TT_Coded.eaf,D16,Visual,1,1,3,3,Correct,2,Director,1,"T1",2047320,2050900,3580,Acoustic,2047320,2050900,3580,"X"
D16_TT_Coded.eaf,D16,Visual,1,0,2,2,Correct,2,Matcher,1,"T1",2047320,2050900,3580,Acoustic,2047320,2050900,3580,"X"
D16_TT_Coded.eaf,D16,Visual,1,2,7,7,Correct,1,Director,1,"T1",2059190,2062800,3610,Acoustic,2059190,2062800,3610,"X"
D16_TT_Coded.eaf,D16,Visual,1,3,1,6,Incorrect,2,Director,1,"T1",2064700,2066510,1810,Acoustic,2064700,2066510,1810,"X"
D16_TT_Coded.eaf,D16,Visual,1,4,5,6,Incorrect,1,Director,1,"T1",2077500,2081200,3700,Acoustic,2077505,2078605,1100,"X"
D16_TT_Coded.eaf,D16,Visual,1,4,5,6,Incorrect,1,Director,1,"T1",2077500,2081200,3700,Acoustic,2078890,2079900,1010,"X"
D16_TT_Coded.eaf,D16,Visual,1,4,5,6,Incorrect,1,Director,1,"T1",2077500,2081200,3700,Acoustic,2080210,2081200,990,"X"
D16_TT_Coded.eaf,D16,Visual,1,5,4,4,Correct,2,Director,1,"T1",2086680,2091220,4540,Acoustic,2086680,2091220,4540,"X"
D16_TT_Coded.eaf,D16,Visual,1,6,3,3,Correct,1,Director,1,"T1",2103700,2106510,2810,Acoustic,2103700,2106510,2810,"X"
D16_TT_Coded.eaf,D16,Visual,1,7,8,5,Incorrect,2,Director,1,"T1",2115310,2118510,3200,Acoustic,2115310,2118510,3200,"X"
D16_TT_Coded.eaf,D16,Visual,1,8,6,8,Incorrect,1,Director,1,"T1",2125205,2128005,2800,Acoustic,2125205,2128005,2800,"X"
D16_TT_Coded.eaf,D16,Visual,1,9,2,2,Correct,2,Director,1,"T1",2131300,2133210,1910,Acoustic,2131300,2133210,1910,"X"
D16_TT_Coded.eaf,D16,Visual,1,10,4,4,Correct,1,Director,1,"T1",2141700,2145800,4100,Acoustic,2141700,2145800,4100,"X"
D16_TT_Coded.eaf,D16,Visual,1,11,7,7,Correct,2,Director,1,"T1",2160300,2161710,1410,Acoustic,2160300,2161710,1410,"X"
D16_TT_Coded.eaf,D16,Visual,1,12,8,6,Incorrect,1,Director,1,"T1",2181100,2184000,2900,Acoustic,2181100,2184000,2900,"X"
D16_TT_Coded.eaf,D16,Visual,1,13,6,8,Incorrect,2,Director,1,"T1",2186610,2189500,2890,Acoustic,2186610,2189500,2890,"X"
D16_TT_Coded.eaf,D16,Visual,1,13,6,8,Incorrect,1,Matcher,1,"T1",2196500,2198900,2400,Acoustic,2196500,2198900,2400,"X"
D16_TT_Coded.eaf,D16,Visual,1,14,1,7,Incorrect,1,Director,1,"T1",2196500,2198900,2400,Acoustic,2196500,2198900,2400,"X"
D16_TT_Coded.eaf,D16,Visual,1,15,5,5,Correct,2,Director,1,"T1",2214910,2217110,2200,Acoustic,2214910,2217110,2200,"X"
D16_TT_Coded.eaf,D16,Visual,2,0,7,7,Correct,1,Director,1,"T1",2235690,2235700,10,Acoustic,2235690,2235700,10,"X"
D16_TT_Coded.eaf,D16,Visual,2,0,7,7,Correct,1,Director,2,"T1",2235700,2239600,3900,Acoustic,2235690,2235700,10,"X"
D16_TT_Coded.eaf,D16,Visual,2,0,7,7,Correct,1,Director,1,"T1",2235690,2235700,10,Acoustic,2235700,2239600,3900,"X"
D16_TT_Coded.eaf,D16,Visual,2,0,7,7,Correct,1,Director,2,"T1",2235700,2239600,3900,Acoustic,2235700,2239600,3900,"X"
D16_TT_Coded.eaf,D16,Visual,2,1,1,4,Incorrect,2,Director,1,"T1",2241305,2243605,2300,Acoustic,2241305,2243605,2300,"X"
D16_TT_Coded.eaf,D16,Visual,2,2,3,3,Correct,1,Director,1,"T1",2252190,2254910,2720,Acoustic,2252190,2254910,2720,"X"
D16_TT_Coded.eaf,D16,Visual,2,3,8,8,Correct,2,Director,1,"T1",2259005,2261915,2910,Acoustic,2259005,2261915,2910,"X"
D16_TT_Coded.eaf,D16,Visual,2,3,8,8,Correct,1,Matcher,1,"X",2271490,2274800,3310,Acoustic,2271490,2274800,3310,"X"
D16_TT_Coded.eaf,D16,Visual,2,4,5,7,Incorrect,1,Director,1,"X",2271490,2274800,3310,Acoustic,2271490,2274800,3310,"X"
D16_TT_Coded.eaf,D16,Visual,2,5,4,4,Correct,2,Director,1,"T1",2285610,2289900,4290,Acoustic,2285610,2289900,4290,"X"
D16_TT_Coded.eaf,D16,Visual,2,5,4,4,Correct,1,Matcher,1,"T1",2298610,2302500,3890,Acoustic,2298610,2302500,3890,"X"
D16_TT_Coded.eaf,D16,Visual,2,6,6,8,Incorrect,1,Director,1,"T1",2298610,2302500,3890,Acoustic,2298610,2302500,3890,"X"
D16_TT_Coded.eaf,D16,Visual,2,7,2,2,Correct,2,Director,1,"T1",2309410,2311490,2080,Acoustic,2309410,2311490,2080,"X"
D16_TT_Coded.eaf,D16,Visual,2,8,1,7,Incorrect,1,Director,1,"T1",2315105,2317905,2800,Acoustic,2315105,2317905,2800,"X"
D16_TT_Coded.eaf,D16,Visual,2,9,5,3,Incorrect,2,Director,1,"T1",2323800,2326900,3100,Acoustic,2323800,2326900,3100,"X"
D16_TT_Coded.eaf,D16,Visual,2,10,2,2,Correct,1,Director,1,"T1",2333610,2335400,1790,Acoustic,2333610,2335400,1790,"X"
D16_TT_Coded.eaf,D16,Visual,2,11,3,4,Incorrect,2,Director,1,"T1",2338700,2341500,2800,Acoustic,2338700,2341500,2800,"X"
D16_TT_Coded.eaf,D16,Visual,2,11,3,4,Incorrect,1,Matcher,1,"T1",2351900,2355900,4000,Acoustic,2351900,2355900,4000,"X"
D16_TT_Coded.eaf,D16,Visual,2,12,8,8,Correct,1,Director,1,"T1",2351900,2355900,4000,Acoustic,2351900,2355900,4000,"X"
D16_TT_Coded.eaf,D16,Visual,2,13,6,8,Incorrect,2,Director,1,"T1",2361800,2365600,3800,Acoustic,2361800,2365600,3800,"X"
D16_TT_Coded.eaf,D16,Visual,2,14,4,5,Incorrect,1,Director,1,"T1",2389400,2392200,2800,Acoustic,2389400,2392200,2800,"X"
D16_TT_Coded.eaf,D16,Visual,2,15,7,7,Correct,2,Director,1,"T1",2398990,2400700,1710,Acoustic,2398990,2400700,1710,"X"
D16_TT_Coded.eaf,D16,Visual,3,0,8,8,Correct,1,Director,1,"T1",2419000,2421800,2800,Acoustic,2419000,2421800,2800,"X"
D16_TT_Coded.eaf,D16,Visual,3,1,6,8,Incorrect,2,Director,1,"T1",2424405,2427005,2600,Acoustic,2424405,2427005,2600,"X"
D16_TT_Coded.eaf,D16,Visual,3,1,6,8,Incorrect,1,Matcher,1,"T1",2434900,2438110,3210,Acoustic,2434900,2438110,3210,"X"
D16_TT_Coded.eaf,D16,Visual,3,2,5,5,Correct,1,Director,1,"T1",2434900,2438110,3210,Acoustic,2434900,2438110,3210,"X"
D16_TT_Coded.eaf,D16,Visual,3,3,4,4,Correct,2,Director,1,"T1",2444910,2449140,4230,Acoustic,2444910,2449140,4230,"X"
D16_TT_Coded.eaf,D16,Visual,3,3,4,4,Correct,1,Matcher,1,"T1",2453390,2455600,2210,Acoustic,2453390,2455600,2210,"X"
D16_TT_Coded.eaf,D16,Visual,3,4,2,2,Correct,1,Director,1,"T1",2453390,2455600,2210,Acoustic,2453390,2455600,2210,"X"
D16_TT_Coded.eaf,D16,Visual,3,5,3,3,Correct,2,Director,1,"T1",2462410,2464510,2100,Acoustic,2462410,2464510,2100,"X"
D16_TT_Coded.eaf,D16,Visual,3,5,3,3,Correct,1,Matcher,1,"T1",2474000,2477500,3500,Acoustic,2474000,2477500,3500,"X"
D16_TT_Coded.eaf,D16,Visual,3,6,6,8,Incorrect,1,Director,1,"T1",2474000,2477500,3500,Acoustic,2474000,2477500,3500,"X"
D16_TT_Coded.eaf,D16,Visual,3,7,2,2,Correct,2,Director,1,"T1",2480515,2482615,2100,Acoustic,2480515,2482615,2100,"X"
D16_TT_Coded.eaf,D16,Visual,3,6,6,8,Incorrect,2,Matcher,1,"T1",2480515,2482615,2100,Acoustic,2480515,2482615,2100,"X"
D16_TT_Coded.eaf,D16,Visual,3,8,4,5,Incorrect,1,Director,1,"T1",2488400,2491600,3200,Acoustic,2488400,2491600,3200,"X"
D16_TT_Coded.eaf,D16,Visual,3,9,7,7,Correct,1,Matcher,1,"T1",2501610,2503310,1700,Acoustic,2501610,2503310,1700,"X"
D16_TT_Coded.eaf,D16,Visual,3,10,3,3,Correct,1,Director,1,"T1",2513010,2517010,4000,Acoustic,2513010,2517010,4000,"X"
D16_TT_Coded.eaf,D16,Visual,3,11,8,8,Correct,2,Director,1,"T1",2518805,2522105,3300,Acoustic,2518805,2522105,3300,"X"
D16_TT_Coded.eaf,D16,Visual,3,12,1,7,Incorrect,1,Director,1,"T1",2532500,2535200,2700,Acoustic,2532500,2535200,2700,"X"
D16_TT_Coded.eaf,D16,Visual,3,13,5,5,Correct,2,Director,1,"T1",2541400,2543400,2000,Acoustic,2541400,2543400,2000,"X"
D16_TT_Coded.eaf,D16,Visual,3,14,7,7,Correct,1,Director,1,"T1",2553810,2557500,3690,Acoustic,2553810,2557500,3690,"X"
D16_TT_Coded.eaf,D16,Visual,3,15,1,4,Incorrect,2,Director,1,"T1",2558810,2561010,2200,Acoustic,2558810,2561010,2200,"X"
D16_TT_Coded.eaf,D16,Visual,3,14,7,7,Correct,2,Matcher,1,"T1",2558810,2561010,2200,Acoustic,2558810,2561010,2200,"X"