filename,dyadNumber,condition,game,trial,target,choice,correct,signallingPlayer,role,turnNumber,turnType,turnStart,turnEnd,turnLength,modality,signalStart,signalEnd,signalLength,signalType
D18_TT_Coded.eaf,D18,Auditory,0,0,7,7,Correct,1,Director,1,"T1",39391,48459,9068,Acoustic,39404,41026,1622,"X"
D18_TT_Coded.eaf,D18,Auditory,0,0,7,7,Correct,1,Director,1,"T1",39391,48459,9068,Visual,39404,41026,1622,"X"
D18_TT_Coded.eaf,D18,Auditory,0,0,7,7,Correct,1,Director,1,"T1",39391,48459,9068,Visual,45026,48418,3392,"X"
D18_TT_Coded.eaf,D18,Auditory,0,0,7,7,Correct,1,Director,1,"T1",39391,48459,9068,Acoustic,47418,48445,1027,"X"
D18_TT_Coded.eaf,D18,Auditory,0,0,7,7,Correct,2,Matcher,1,"T2",57405,58810,1405,Visual,57405,58810,1405,"X"
D18_TT_Coded.eaf,D18,Auditory,0,0,7,7,Correct,1,Director,2,"T3",58215,63229,5014,Visual,58215,63229,5014,"X"
D18_TT_Coded.eaf,D18,Auditory,0,0,7,7,Correct,1,Director,2,"T3",58215,63229,5014,Acoustic,61824,63256,1432,"X"
D18_TT_Coded.eaf,D18,Auditory,0,0,7,7,Correct,2,Matcher,2,"T4",66404,75053,8649,Visual,66418,69418,3000,"X"
D18_TT_Coded.eaf,D18,Auditory,0,0,7,7,Correct,2,Matcher,2,"T4",66404,75053,8649,Visual,71620,75039,3419,"X"
D18_TT_Coded.eaf,D18,Auditory,0,0,7,7,Correct,1,Director,3,"T5",75066,79026,3960,Visual,75066,79026,3960,"X"
D18_TT_Coded.eaf,D18,Auditory,0,0,7,7,Correct,1,Director,3,"T5",75066,79026,3960,Acoustic,76837,79040,2203,"X"
D18_TT_Coded.eaf,D18,Auditory,0,1,1,1,Correct,2,Director,1,"T1",88229,92418,4189,Visual,88229,92418,4189,"X"
D18_TT_Coded.eaf,D18,Auditory,0,1,1,1,Correct,2,Director,1,"T1",88229,92418,4189,Acoustic,89040,92432,3392,"X"
D18_TT_Coded.eaf,D18,Auditory,0,2,3,3,Correct,1,Director,1,"T1",107607,108824,1217,Acoustic,107607,108824,1217,"X"
D18_TT_Coded.eaf,D18,Auditory,0,2,3,3,Correct,1,Director,1,"T1",107607,108824,1217,Visual,107607,108824,1217,"X"
D18_TT_Coded.eaf,D18,Auditory,0,2,3,3,Correct,2,Matcher,1,"T2",112012,112620,608,Acoustic,112012,112620,608,"X"
D18_TT_Coded.eaf,D18,Auditory,0,2,3,3,Correct,2,Matcher,1,"T2",112012,112620,608,Visual,112012,112620,608,"X"
D18_TT_Coded.eaf,D18,Auditory,0,2,3,3,Correct,1,Director,2,"T3",121404,126418,5014,Visual,121418,123620,2202,"X"
D18_TT_Coded.eaf,D18,Auditory,0,2,3,3,Correct,1,Director,2,"T3",121404,126418,5014,Acoustic,121607,123418,1811,"X"
D18_TT_Coded.eaf,D18,Auditory,0,2,3,3,Correct,1,Director,2,"T3",121404,126418,5014,Visual,125040,126404,1364,"X"
D18_TT_Coded.eaf,D18,Auditory,0,3,8,8,Correct,2,Director,1,"T1",131228,133620,2392,Visual,131228,133620,2392,"X"
D18_TT_Coded.eaf,D18,Auditory,0,3,8,8,Correct,2,Director,1,"T1",131228,133620,2392,Acoustic,131431,133512,2081,"X"
D18_TT_Coded.eaf,D18,Auditory,0,3,8,8,Correct,1,Matcher,1,"T1",136621,137621,1000,Visual,136621,137621,1000,"X"
D18_TT_Coded.eaf,D18,Auditory,0,3,8,8,Correct,1,Matcher,1,"T1",136621,137621,1000,Acoustic,137039,137418,379,"X"
D18_TT_Coded.eaf,D18,Auditory,0,5,4,4,Correct,2,Director,1,"T1",147823,149040,1217,Acoustic,147823,149040,1217,"X"
D18_TT_Coded.eaf,D18,Auditory,0,5,4,4,Correct,2,Director,1,"T1",147823,149040,1217,Visual,147823,149040,1217,"X"
D18_TT_Coded.eaf,D18,Auditory,0,5,4,4,Correct,2,Director,1,"T1",147823,149040,1217,Acoustic,149040,149053,13,"X"
D18_TT_Coded.eaf,D18,Auditory,0,6,6,6,Correct,1,Director,1,"T1",155202,157216,2014,Visual,155202,157216,2014,"X"
D18_TT_Coded.eaf,D18,Auditory,0,6,6,6,Correct,1,Director,1,"T1",155202,157216,2014,Acoustic,155445,157229,1784,"X"
D18_TT_Coded.eaf,D18,Auditory,0,7,2,2,Correct,2,Director,1,"T1",169837,174026,4189,Visual,169837,174026,4189,"X"
D18_TT_Coded.eaf,D18,Auditory,0,7,2,2,Correct,2,Director,1,"T1",169837,174026,4189,Acoustic,171404,173715,2311,"X"
D18_TT_Coded.eaf,D18,Auditory,0,8,1,1,Correct,1,Director,1,"T1",177418,178824,1406,Acoustic,177418,178824,1406,"X"
D18_TT_Coded.eaf,D18,Auditory,0,8,1,1,Correct,1,Director,1,"T1",177418,178824,1406,Visual,177418,178824,1406,"X"
D18_TT_Coded.eaf,D18,Auditory,0,9,5,5,Correct,2,Director,1,"T1",186621,187621,1000,Visual,186621,187621,1000,"X"
D18_TT_Coded.eaf,D18,Auditory,0,9,5,5,Correct,2,Director,1,"T1",186621,187621,1000,Acoustic,187229,187634,405,"X"
D18_TT_Coded.eaf,D18,Auditory,0,11,3,3,Correct,1,Matcher,1,"T1",191175,204242,13067,Visual,191189,192824,1635,"X"
D18_TT_Coded.eaf,D18,Auditory,0,10,2,2,Correct,1,Director,1,"T1",191175,204242,13067,Visual,191189,192824,1635,"X"
D18_TT_Coded.eaf,D18,Auditory,0,11,3,3,Correct,1,Matcher,1,"T1",191175,204242,13067,Acoustic,191621,192621,1000,"X"
D18_TT_Coded.eaf,D18,Auditory,0,10,2,2,Correct,1,Director,1,"T1",191175,204242,13067,Acoustic,191621,192621,1000,"X"
D18_TT_Coded.eaf,D18,Auditory,0,11,3,3,Correct,1,Matcher,1,"T1",191175,204242,13067,Visual,203229,204229,1000,"X"
D18_TT_Coded.eaf,D18,Auditory,0,10,2,2,Correct,1,Director,1,"T1",191175,204242,13067,Visual,203229,204229,1000,"X"
D18_TT_Coded.eaf,D18,Auditory,0,11,3,3,Correct,2,Director,1,"T1",207796,211242,3446,Acoustic,207796,211242,3446,"X"
D18_TT_Coded.eaf,D18,Auditory,0,11,3,3,Correct,2,Director,1,"T1",207796,211242,3446,Visual,207796,210621,2825,"X"
D18_TT_Coded.eaf,D18,Auditory,0,12,8,8,Correct,1,Director,1,"T1",212405,214621,2216,Acoustic,212405,214621,2216,"X"
D18_TT_Coded.eaf,D18,Auditory,0,12,8,8,Correct,1,Director,1,"T1",212405,214621,2216,Visual,212405,214621,2216,"X"
D18_TT_Coded.eaf,D18,Auditory,0,13,6,6,Correct,2,Director,1,"T1",219608,222013,2405,Visual,219608,222013,2405,"X"
D18_TT_Coded.eaf,D18,Auditory,0,13,6,6,Correct,2,Director,1,"T1",219608,222013,2405,Acoustic,219620,221620,2000,"X"
D18_TT_Coded.eaf,D18,Auditory,0,14,4,4,Correct,1,Director,1,"T1",224431,225823,1392,Acoustic,224431,225823,1392,"X"
D18_TT_Coded.eaf,D18,Auditory,0,14,4,4,Correct,1,Director,1,"T1",224431,225823,1392,Visual,224431,225823,1392,"X"
D18_TT_Coded.eaf,D18,Auditory,0,15,7,7,Correct,2,Director,1,"T1",234216,237837,3621,Acoustic,234216,237837,3621,"X"
D18_TT_Coded.eaf,D18,Auditory,0,15,7,7,Correct,2,Director,1,"T1",234216,237837,3621,Visual,234216,237837,3621,"X"
D18_TT_Coded.eaf,D18,Auditory,0,15,7,7,Correct,1,Matcher,1,"T1",247026,249026,2000,Visual,247026,249026,2000,"X"
D18_TT_Coded.eaf,D18,Auditory,1,0,8,8,Correct,1,Director,1,"T1",247026,249026,2000,Visual,247026,249026,2000,"X"
D18_TT_Coded.eaf,D18,Auditory,0,15,7,7,Correct,1,Matcher,1,"T1",247026,249026,2000,Acoustic,247418,248824,1406,"X"
D18_TT_Coded.eaf,D18,Auditory,1,0,8,8,Correct,1,Director,1,"T1",247026,249026,2000,Acoustic,247418,248824,1406,"X"
D18_TT_Coded.eaf,D18,Auditory,1,1,6,6,Correct,2,Director,1,"T1",256418,258621,2203,Acoustic,256418,258621,2203,"X"
D18_TT_Coded.eaf,D18,Auditory,1,1,6,6,Correct,2,Director,1,"T1",256418,258621,2203,Visual,256418,258621,2203,"X"
D18_TT_Coded.eaf,D18,Auditory,1,2,5,5,Correct,1,Director,1,"T1",262431,263418,987,Visual,262431,263418,987,"X"
D18_TT_Coded.eaf,D18,Auditory,1,2,5,5,Correct,1,Director,1,"T1",262431,263418,987,Acoustic,263026,263431,405,"X"
D18_TT_Coded.eaf,D18,Auditory,1,3,4,4,Correct,2,Director,1,"T1",269824,271216,1392,Visual,269824,271216,1392,"X"
D18_TT_Coded.eaf,D18,Auditory,1,3,4,4,Correct,2,Director,1,"T1",269824,271216,1392,Acoustic,270431,271053,622,"X"
D18_TT_Coded.eaf,D18,Auditory,1,4,2,2,Correct,1,Director,1,"T1",274824,276026,1202,Visual,274824,276026,1202,"X"
D18_TT_Coded.eaf,D18,Auditory,1,4,2,2,Correct,1,Director,1,"T1",274824,276026,1202,Acoustic,275012,276039,1027,"X"
D18_TT_Coded.eaf,D18,Auditory,1,5,3,3,Correct,2,Director,1,"T1",283215,285620,2405,Visual,283201,285228,2027,"X"
D18_TT_Coded.eaf,D18,Auditory,1,5,3,3,Correct,2,Director,1,"T1",283215,285620,2405,Acoustic,283215,285620,2405,"X"
D18_TT_Coded.eaf,D18,Auditory,1,6,6,6,Correct,1,Director,1,"T1",287608,289608,2000,Visual,287608,289608,2000,"X"
D18_TT_Coded.eaf,D18,Auditory,1,6,6,6,Correct,1,Director,1,"T1",287608,289608,2000,Acoustic,287824,289608,1784,"X"
D18_TT_Coded.eaf,D18,Auditory,1,7,2,1,Incorrect,2,Director,1,"T1",294228,296026,1798,Visual,294228,296026,1798,"X"
D18_TT_Coded.eaf,D18,Auditory,1,7,2,1,Incorrect,2,Director,1,"T1",294228,296026,1798,Acoustic,295026,296039,1013,"X"
D18_TT_Coded.eaf,D18,Auditory,1,8,4,4,Correct,1,Director,1,"T1",300824,301418,594,Visual,300824,301418,594,"X"
D18_TT_Coded.eaf,D18,Auditory,1,8,4,4,Correct,1,Director,1,"T1",300824,301418,594,Acoustic,301026,301256,230,"X"
D18_TT_Coded.eaf,D18,Auditory,1,9,7,7,Correct,2,Director,1,"T1",307823,311850,4027,Acoustic,307824,311026,3202,"X"
D18_TT_Coded.eaf,D18,Auditory,1,9,7,7,Correct,2,Director,1,"T1",307823,311850,4027,Visual,307824,311026,3202,"X"
D18_TT_Coded.eaf,D18,Auditory,1,9,7,7,Correct,2,Director,1,"T1",307823,311850,4027,Acoustic,311404,311836,432,"X"
D18_TT_Coded.eaf,D18,Auditory,1,10,3,3,Correct,1,Director,1,"T1",315431,317215,1784,Visual,315431,317215,1784,"X"
D18_TT_Coded.eaf,D18,Auditory,1,10,3,3,Correct,1,Director,1,"T1",315431,317215,1784,Acoustic,315810,317229,1419,"X"
D18_TT_Coded.eaf,D18,Auditory,1,11,8,8,Correct,2,Director,1,"T1",322026,324621,2595,Visual,322026,324621,2595,"X"
D18_TT_Coded.eaf,D18,Auditory,1,11,8,8,Correct,2,Director,1,"T1",322026,324621,2595,Acoustic,322296,324634,2338,"X"
D18_TT_Coded.eaf,D18,Auditory,1,12,1,1,Correct,1,Director,1,"T1",327797,329797,2000,Visual,327797,329797,2000,"X"
D18_TT_Coded.eaf,D18,Auditory,1,12,1,1,Correct,1,Director,1,"T1",327797,329797,2000,Acoustic,328040,329621,1581,"X"
D18_TT_Coded.eaf,D18,Auditory,1,13,5,5,Correct,2,Director,1,"T1",336418,337621,1203,Visual,336418,337621,1203,"X"
D18_TT_Coded.eaf,D18,Auditory,1,13,5,5,Correct,2,Director,1,"T1",336418,337621,1203,Acoustic,337013,337634,621,"X"
D18_TT_Coded.eaf,D18,Auditory,1,14,7,7,Correct,1,Director,1,"T1",341418,343620,2202,Acoustic,341418,343229,1811,"X"
D18_TT_Coded.eaf,D18,Auditory,1,14,7,7,Correct,1,Director,1,"T1",341418,343620,2202,Visual,341418,343620,2202,"X"
D18_TT_Coded.eaf,D18,Auditory,1,15,1,1,Correct,2,Director,1,"T1",349418,351823,2405,Acoustic,349418,351823,2405,"X"
D18_TT_Coded.eaf,D18,Auditory,1,15,1,1,Correct,2,Director,1,"T1",349418,351823,2405,Visual,349418,351823,2405,"X"
D18_TT_Coded.eaf,D18,Auditory,2,0,3,3,Correct,1,Director,1,"T1",363242,365026,1784,Acoustic,363242,365026,1784,"X"
D18_TT_Coded.eaf,D18,Auditory,2,0,3,3,Correct,1,Director,1,"T1",363242,365026,1784,Visual,363242,365026,1784,"X"
D18_TT_Coded.eaf,D18,Auditory,2,1,8,8,Correct,2,Director,1,"T1",367391,369621,2230,Visual,367391,369621,2230,"X"
D18_TT_Coded.eaf,D18,Auditory,2,0,3,3,Correct,2,Matcher,1,"T1",367391,369621,2230,Visual,367391,369621,2230,"X"
D18_TT_Coded.eaf,D18,Auditory,2,1,8,8,Correct,2,Director,1,"T1",367391,369621,2230,Acoustic,367607,369634,2027,"X"
D18_TT_Coded.eaf,D18,Auditory,2,0,3,3,Correct,2,Matcher,1,"T1",367391,369621,2230,Acoustic,367607,369634,2027,"X"
D18_TT_Coded.eaf,D18,Auditory,2,2,4,4,Correct,1,Director,1,"T1",372040,372824,784,Visual,372040,372824,784,"X"
D18_TT_Coded.eaf,D18,Auditory,2,2,4,4,Correct,1,Director,1,"T1",372040,372824,784,Acoustic,372229,372621,392,"X"
D18_TT_Coded.eaf,D18,Auditory,2,3,7,7,Correct,2,Director,1,"T1",378823,381026,2203,Acoustic,378823,381026,2203,"X"
D18_TT_Coded.eaf,D18,Auditory,2,3,7,7,Correct,2,Director,1,"T1",378823,381026,2203,Visual,378823,381026,2203,"X"
D18_TT_Coded.eaf,D18,Auditory,2,4,6,6,Correct,1,Director,1,"T1",383621,385580,1959,Acoustic,383621,385580,1959,"X"
D18_TT_Coded.eaf,D18,Auditory,2,4,6,6,Correct,1,Director,1,"T1",383621,385580,1959,Visual,383621,385580,1959,"X"
D18_TT_Coded.eaf,D18,Auditory,2,5,2,2,Correct,2,Director,1,"T1",389432,391418,1986,Acoustic,389432,391418,1986,"X"
D18_TT_Coded.eaf,D18,Auditory,2,5,2,2,Correct,2,Director,1,"T1",389432,391418,1986,Visual,389432,391418,1986,"X"
D18_TT_Coded.eaf,D18,Auditory,2,6,8,8,Correct,1,Director,1,"T1",393810,395405,1595,Visual,393810,395405,1595,"X"
D18_TT_Coded.eaf,D18,Auditory,2,6,8,8,Correct,1,Director,1,"T1",393810,395405,1595,Acoustic,394013,395418,1405,"X"
D18_TT_Coded.eaf,D18,Auditory,2,7,3,3,Correct,2,Director,1,"T1",398824,401824,3000,Visual,398824,401824,3000,"X"
D18_TT_Coded.eaf,D18,Auditory,2,7,3,3,Correct,2,Director,1,"T1",398824,401824,3000,Acoustic,399026,401810,2784,"X"
D18_TT_Coded.eaf,D18,Auditory,2,8,2,2,Correct,1,Director,1,"T1",403634,405418,1784,Visual,403634,405418,1784,"X"
D18_TT_Coded.eaf,D18,Auditory,2,8,2,2,Correct,1,Director,1,"T1",403634,405418,1784,Acoustic,404027,405027,1000,"X"
D18_TT_Coded.eaf,D18,Auditory,2,9,6,6,Correct,2,Director,1,"T1",411620,413823,2203,Visual,411620,413823,2203,"X"
D18_TT_Coded.eaf,D18,Auditory,2,9,6,6,Correct,2,Director,1,"T1",411620,413823,2203,Acoustic,412013,413837,1824,"X"
D18_TT_Coded.eaf,D18,Auditory,2,10,5,5,Correct,1,Director,1,"T1",416202,417202,1000,Visual,416202,417202,1000,"X"
D18_TT_Coded.eaf,D18,Auditory,2,10,5,5,Correct,1,Director,1,"T1",416202,417202,1000,Acoustic,416634,416837,203,"X"
D18_TT_Coded.eaf,D18,Auditory,2,11,4,4,Correct,2,Director,1,"T1",422202,423823,1621,Acoustic,422175,423621,1446,"X"
D18_TT_Coded.eaf,D18,Auditory,2,11,4,4,Correct,2,Director,1,"T1",422202,423823,1621,Visual,422202,423823,1621,"X"
D18_TT_Coded.eaf,D18,Auditory,2,12,1,1,Correct,1,Director,1,"T1",427823,429607,1784,Visual,427823,429607,1784,"X"
D18_TT_Coded.eaf,D18,Auditory,2,12,1,1,Correct,1,Director,1,"T1",427823,429607,1784,Acoustic,428229,429621,1392,"X"
D18_TT_Coded.eaf,D18,Auditory,2,13,5,5,Correct,2,Director,1,"T1",432202,433418,1216,Visual,432202,433418,1216,"X"
D18_TT_Coded.eaf,D18,Auditory,2,13,5,5,Correct,2,Director,1,"T1",432202,433418,1216,Acoustic,432918,433228,310,"X"
D18_TT_Coded.eaf,D18,Auditory,2,14,7,7,Correct,1,Director,1,"T1",437405,439608,2203,Acoustic,437405,439608,2203,"X"
D18_TT_Coded.eaf,D18,Auditory,2,14,7,7,Correct,1,Director,1,"T1",437405,439608,2203,Visual,437405,439608,2203,"X"
D18_TT_Coded.eaf,D18,Auditory,2,15,1,1,Correct,2,Director,1,"T1",444000,446202,2202,Acoustic,444000,446202,2202,"X"
D18_TT_Coded.eaf,D18,Auditory,2,15,1,1,Correct,2,Director,1,"T1",444000,446202,2202,Visual,444000,446202,2202,"X"
D18_TT_Coded.eaf,D18,Auditory,3,0,2,2,Correct,1,Director,1,"T1",453229,454621,1392,Visual,453229,454621,1392,"X"
D18_TT_Coded.eaf,D18,Auditory,3,0,2,2,Correct,1,Director,1,"T1",453229,454621,1392,Acoustic,453620,454634,1014,"X"
D18_TT_Coded.eaf,D18,Auditory,3,1,3,3,Correct,2,Director,1,"T1",459039,462229,3190,Acoustic,459039,462229,3190,"X"
D18_TT_Coded.eaf,D18,Auditory,3,1,3,3,Correct,2,Director,1,"T1",459039,462229,3190,Visual,459039,462229,3190,"X"
D18_TT_Coded.eaf,D18,Auditory,3,0,2,2,Correct,2,Matcher,1,"T1",459039,462229,3190,Acoustic,459039,462229,3190,"X"
D18_TT_Coded.eaf,D18,Auditory,3,0,2,2,Correct,2,Matcher,1,"T1",459039,462229,3190,Visual,459039,462229,3190,"X"
D18_TT_Coded.eaf,D18,Auditory,3,2,7,7,Correct,1,Director,1,"T1",464418,467418,3000,Visual,464418,467418,3000,"X"
D18_TT_Coded.eaf,D18,Auditory,3,2,7,7,Correct,1,Director,1,"T1",464418,467418,3000,Acoustic,464620,467228,2608,"X"
D18_TT_Coded.eaf,D18,Auditory,3,3,1,1,Correct,2,Director,1,"T1",473620,475620,2000,Acoustic,473620,475620,2000,"X"
D18_TT_Coded.eaf,D18,Auditory,3,3,1,1,Correct,2,Director,1,"T1",473620,475620,2000,Visual,473620,475620,2000,"X"
D18_TT_Coded.eaf,D18,Auditory,3,4,5,5,Correct,1,Director,1,"T1",477228,478215,987,Visual,477228,478215,987,"X"
D18_TT_Coded.eaf,D18,Auditory,3,4,5,5,Correct,1,Director,1,"T1",477228,478215,987,Acoustic,477418,478026,608,"X"
D18_TT_Coded.eaf,D18,Auditory,3,5,4,4,Correct,2,Director,1,"T1",483027,484216,1189,Visual,483027,484216,1189,"X"
D18_TT_Coded.eaf,D18,Auditory,3,5,4,4,Correct,2,Director,1,"T1",483027,484216,1189,Acoustic,483607,484026,419,"X"
D18_TT_Coded.eaf,D18,Auditory,3,6,3,3,Correct,1,Director,1,"T1",486418,488634,2216,Visual,486418,488634,2216,"X"
D18_TT_Coded.eaf,D18,Auditory,3,7,8,8,Correct,2,Director,1,"T1",493215,495215,2000,Visual,493215,495215,2000,"X"
D18_TT_Coded.eaf,D18,Auditory,3,7,8,8,Correct,2,Director,1,"T1",493215,495215,2000,Acoustic,493607,495229,1622,"X"
D18_TT_Coded.eaf,D18,Auditory,3,8,6,6,Correct,1,Director,1,"T1",498026,499620,1594,Acoustic,498026,499620,1594,"X"
D18_TT_Coded.eaf,D18,Auditory,3,8,6,6,Correct,1,Director,1,"T1",498026,499620,1594,Visual,498026,499620,1594,"X"
D18_TT_Coded.eaf,D18,Auditory,3,9,2,2,Correct,2,Director,1,"T1",502824,504621,1797,Visual,502824,504621,1797,"X"
D18_TT_Coded.eaf,D18,Auditory,3,9,2,2,Correct,2,Director,1,"T1",502824,504621,1797,Acoustic,503229,504634,1405,"X"
D18_TT_Coded.eaf,D18,Auditory,3,9,2,2,Correct,1,Matcher,1,"T1",507810,508621,811,Visual,507810,508621,811,"X"
D18_TT_Coded.eaf,D18,Auditory,3,10,4,4,Correct,1,Director,1,"T1",507810,508621,811,Visual,507810,508621,811,"X"
D18_TT_Coded.eaf,D18,Auditory,3,9,2,2,Correct,1,Matcher,1,"T1",507810,508621,811,Acoustic,508026,508418,392,"X"
D18_TT_Coded.eaf,D18,Auditory,3,10,4,4,Correct,1,Director,1,"T1",507810,508621,811,Acoustic,508026,508418,392,"X"
D18_TT_Coded.eaf,D18,Auditory,3,11,7,7,Correct,2,Director,1,"T1",515229,517824,2595,Acoustic,515229,517824,2595,"X"
D18_TT_Coded.eaf,D18,Auditory,3,11,7,7,Correct,2,Director,1,"T1",515229,517824,2595,Visual,515229,517824,2595,"X"
D18_TT_Coded.eaf,D18,Auditory,3,12,8,8,Correct,1,Director,1,"T1",519432,521418,1986,Visual,519432,521418,1986,"X"
D18_TT_Coded.eaf,D18,Auditory,3,12,8,8,Correct,1,Director,1,"T1",519432,521418,1986,Acoustic,519836,521431,1595,"X"
D18_TT_Coded.eaf,D18,Auditory,3,13,6,6,Correct,2,Director,1,"T1",524215,526026,1811,Acoustic,524215,526026,1811,"X"
D18_TT_Coded.eaf,D18,Auditory,3,13,6,6,Correct,2,Director,1,"T1",524215,526026,1811,Visual,524215,526026,1811,"X"
D18_TT_Coded.eaf,D18,Auditory,3,14,1,1,Correct,1,Director,1,"T1",528215,530215,2000,Visual,528215,530215,2000,"X"
D18_TT_Coded.eaf,D18,Auditory,3,14,1,1,Correct,1,Director,1,"T1",528215,530215,2000,Acoustic,528621,530216,1595,"X"
D18_TT_Coded.eaf,D18,Auditory,3,15,5,5,Correct,2,Director,1,"T1",532837,534215,1378,Visual,532837,534215,1378,"X"
D18_TT_Coded.eaf,D18,Auditory,3,15,5,5,Correct,2,Director,1,"T1",532837,534215,1378,Acoustic,533608,534229,621,"X"
D18_TT_Coded.eaf,D18,Visual,0,0,3,5,Incorrect,1,Director,1,"T1",609620,615836,6216,Visual,609621,612229,2608,"X"
D18_TT_Coded.eaf,D18,Visual,0,0,3,5,Incorrect,1,Director,1,"T1",609620,615836,6216,Visual,613026,615823,2797,"X"
D18_TT_Coded.eaf,D18,Visual,0,0,3,5,Incorrect,2,Matcher,1,"T2",618594,621242,2648,Visual,618594,621242,2648,"X"
D18_TT_Coded.eaf,D18,Visual,0,0,3,5,Incorrect,1,Director,2,"T3",620026,627634,7608,Visual,620026,627634,7608,"X"
D18_TT_Coded.eaf,D18,Visual,0,1,8,5,Incorrect,2,Director,1,"T1",638418,645418,7000,Visual,638418,645418,7000,"X"
D18_TT_Coded.eaf,D18,Visual,0,2,4,4,Correct,1,Director,1,"T1",651810,657216,5406,Visual,651810,657216,5406,"X"
D18_TT_Coded.eaf,D18,Visual,0,2,4,4,Correct,1,Director,1,"T1",651810,657216,5406,Acoustic,655823,657013,1190,"X"
D18_TT_Coded.eaf,D18,Visual,0,2,4,4,Correct,2,Matcher,1,"T2",663039,663836,797,Visual,663039,663836,797,"X"
D18_TT_Coded.eaf,D18,Visual,0,2,4,4,Correct,1,Director,2,"T3",664039,669026,4987,Visual,664039,669026,4987,"X"
D18_TT_Coded.eaf,D18,Visual,0,2,4,4,Correct,2,Matcher,2,"T4",669040,670608,1568,Acoustic,669040,670608,1568,"X"
D18_TT_Coded.eaf,D18,Visual,0,2,4,4,Correct,2,Matcher,2,"T4",669040,670608,1568,Visual,669040,670608,1568,"X"
D18_TT_Coded.eaf,D18,Visual,0,3,7,7,Correct,1,Matcher,1,"T0",683215,690418,7203,Visual,683215,690418,7203,"X"
D18_TT_Coded.eaf,D18,Visual,0,3,7,7,Correct,2,Director,1,"T0",691026,693228,2202,Visual,691026,693228,2202,"X"
D18_TT_Coded.eaf,D18,Visual,0,3,7,7,Correct,2,Director,2,"T1",695229,696621,1392,Visual,695229,696621,1392,"X"
D18_TT_Coded.eaf,D18,Visual,0,3,7,7,Correct,1,Matcher,2,"T2",702836,706620,3784,Visual,702836,706620,3784,"X"
D18_TT_Coded.eaf,D18,Visual,0,3,7,7,Correct,2,Director,3,"T3",706634,709837,3203,Visual,706634,709837,3203,"X"
D18_TT_Coded.eaf,D18,Visual,0,3,7,7,Correct,1,Matcher,3,"T4",710810,712418,1608,Visual,710810,712418,1608,"X"
D18_TT_Coded.eaf,D18,Visual,0,4,6,2,Incorrect,1,Director,1,"T1",723608,753648,30040,Visual,723608,724810,1202,"X"
D18_TT_Coded.eaf,D18,Visual,0,4,6,2,Incorrect,1,Director,1,"T1",723608,753648,30040,Visual,725607,737432,11825,"X"
D18_TT_Coded.eaf,D18,Visual,0,4,6,2,Incorrect,1,Director,1,"T1",723608,753648,30040,Visual,739229,753635,14406,"X"
D18_TT_Coded.eaf,D18,Visual,0,4,6,2,Incorrect,2,Matcher,1,"T2",753823,761242,7419,Visual,753823,761242,7419,"X"
D18_TT_Coded.eaf,D18,Visual,0,4,6,2,Incorrect,2,Matcher,1,"T2",753823,761242,7419,Acoustic,756229,756621,392,"X"
D18_TT_Coded.eaf,D18,Visual,0,4,6,2,Incorrect,2,Matcher,1,"T2",753823,761242,7419,Acoustic,757418,757823,405,"X"
D18_TT_Coded.eaf,D18,Visual,0,4,6,2,Incorrect,2,Matcher,1,"T2",753823,761242,7419,Acoustic,759229,761256,2027,"X"
D18_TT_Coded.eaf,D18,Visual,0,5,2,1,Incorrect,2,Director,1,"T1",767000,769027,2027,Visual,767000,769027,2027,"X"
D18_TT_Coded.eaf,D18,Visual,0,5,2,1,Incorrect,2,Director,1,"T1",767000,769027,2027,Acoustic,767431,769040,1609,"X"
D18_TT_Coded.eaf,D18,Visual,0,5,2,1,Incorrect,1,Matcher,1,"T2",771593,774837,3244,Visual,771593,774837,3244,"X"
D18_TT_Coded.eaf,D18,Visual,0,6,8,8,Correct,1,Director,1,"T2",771593,774837,3244,Visual,771593,774837,3244,"X"
D18_TT_Coded.eaf,D18,Visual,0,6,8,8,Correct,2,Matcher,1,"T3",779026,780824,1798,Visual,779026,780824,1798,"X"
D18_TT_Coded.eaf,D18,Visual,0,6,8,8,Correct,2,Matcher,1,"T3",779026,780824,1798,Acoustic,779039,780431,1392,"X"
D18_TT_Coded.eaf,D18,Visual,0,6,8,8,Correct,1,Director,2,"T4",784405,786621,2216,Visual,784405,786621,2216,"X"
D18_TT_Coded.eaf,D18,Visual,0,7,3,3,Correct,2,Director,1,"T1",832824,839837,7013,Visual,832824,839837,7013,"X"
D18_TT_Coded.eaf,D18,Visual,0,8,2,2,Correct,1,Director,1,"T1",847216,854027,6811,Visual,847216,854027,6811,"X"
D18_TT_Coded.eaf,D18,Visual,0,8,2,2,Correct,2,Matcher,1,"T2",854026,855418,1392,Visual,854026,855418,1392,"X"
D18_TT_Coded.eaf,D18,Visual,0,8,2,2,Correct,2,Matcher,1,"T2",854026,855418,1392,Acoustic,854607,855432,825,"X"
D18_TT_Coded.eaf,D18,Visual,0,9,6,6,Correct,2,Director,1,"T1",861837,868837,7000,Visual,861837,868837,7000,"X"
D18_TT_Coded.eaf,D18,Visual,0,10,5,5,Correct,1,Director,1,"T1",873432,883418,9986,Visual,873432,883418,9986,"X"
D18_TT_Coded.eaf,D18,Visual,0,11,4,4,Correct,2,Director,1,"T1",885026,888824,3798,Visual,885026,888824,3798,"X"
D18_TT_Coded.eaf,D18,Visual,0,10,5,5,Correct,2,Matcher,1,"T1",885026,888824,3798,Visual,885026,888824,3798,"X"
D18_TT_Coded.eaf,D18,Visual,0,12,1,7,Incorrect,1,Director,1,"T1",891431,895823,4392,Visual,891431,895823,4392,"X"
D18_TT_Coded.eaf,D18,Visual,0,12,1,7,Incorrect,2,Matcher,1,"T2",898391,902242,3851,Visual,898391,902242,3851,"X"
D18_TT_Coded.eaf,D18,Visual,0,12,1,7,Incorrect,1,Director,2,"T3",902418,917445,15027,Visual,902391,904026,1635,"X"
D18_TT_Coded.eaf,D18,Visual,0,12,1,7,Incorrect,1,Director,2,"T3",902418,917445,15027,Visual,911242,917459,6217,"X"
D18_TT_Coded.eaf,D18,Visual,0,13,5,3,Incorrect,2,Director,1,"T4",917621,925823,8202,Visual,917621,925823,8202,"X"
D18_TT_Coded.eaf,D18,Visual,0,12,1,7,Incorrect,2,Matcher,2,"T4",917621,925823,8202,Visual,917621,925823,8202,"X"
D18_TT_Coded.eaf,D18,Visual,0,13,5,3,Incorrect,1,Matcher,1,"T1",982417,986823,4406,Visual,982417,986823,4406,"X"
D18_TT_Coded.eaf,D18,Visual,0,13,5,3,Incorrect,1,Matcher,1,"T1",982417,986823,4406,Acoustic,983823,986621,2798,"X"
D18_TT_Coded.eaf,D18,Visual,0,13,5,5,Correct,2,Director,1,"T1",996634,1002242,5608,Visual,996634,1002242,5608,"X"
D18_TT_Coded.eaf,D18,Visual,0,14,7,7,Correct,1,Director,1,"T1",1004026,1019459,15433,Visual,1004026,1019459,15433,"X"
D18_TT_Coded.eaf,D18,Visual,0,15,1,1,Correct,2,Director,1,"T1",1023418,1026039,2621,Visual,1023418,1026039,2621,"X"
D18_TT_Coded.eaf,D18,Visual,0,15,1,1,Correct,1,Matcher,1,"T1",1027256,1029810,2554,Visual,1027256,1029810,2554,"X"
D18_TT_Coded.eaf,D18,Visual,0,15,1,1,Correct,1,Matcher,1,"T1",1027256,1029810,2554,Acoustic,1028012,1029431,1419,"X"
D18_TT_Coded.eaf,D18,Visual,0,15,1,1,Correct,1,Matcher,2,"T1",1037013,1041027,4014,Visual,1037013,1041027,4014,"X"
D18_TT_Coded.eaf,D18,Visual,1,0,2,2,Correct,1,Director,1,"T1",1037013,1041027,4014,Visual,1037013,1041027,4014,"X"
D18_TT_Coded.eaf,D18,Visual,1,1,3,3,Correct,2,Director,1,"T1",1044999,1049620,4621,Visual,1045000,1047405,2405,"X"
D18_TT_Coded.eaf,D18,Visual,1,1,3,3,Correct,2,Director,1,"T1",1044999,1049620,4621,Visual,1047634,1049607,1973,"X"
D18_TT_Coded.eaf,D18,Visual,1,2,7,7,Correct,1,Director,1,"T1",1052418,1056040,3622,Visual,1052418,1056040,3622,"X"
D18_TT_Coded.eaf,D18,Visual,1,3,1,1,Correct,2,Director,1,"T1",1058851,1060026,1175,Visual,1058851,1060026,1175,"X"
D18_TT_Coded.eaf,D18,Visual,1,4,5,5,Correct,1,Director,1,"T1",1063012,1067431,4419,Visual,1063012,1067431,4419,"X"
D18_TT_Coded.eaf,D18,Visual,1,5,4,4,Correct,2,Director,1,"T1",1069999,1072608,2609,Visual,1069999,1072608,2609,"X"
D18_TT_Coded.eaf,D18,Visual,1,5,4,4,Correct,2,Director,1,"T1",1069999,1072608,2609,Acoustic,1070445,1072418,1973,"X"
D18_TT_Coded.eaf,D18,Visual,1,6,3,3,Correct,1,Director,1,"T1",1075810,1077242,1432,Visual,1075810,1077242,1432,"X"
D18_TT_Coded.eaf,D18,Visual,1,7,8,5,Incorrect,2,Director,1,"T1",1085215,1090431,5216,Visual,1085215,1090431,5216,"X"
D18_TT_Coded.eaf,D18,Visual,1,7,8,5,Incorrect,1,Matcher,1,"T2",1093229,1096405,3176,Visual,1093229,1096405,3176,"X"
D18_TT_Coded.eaf,D18,Visual,1,7,8,5,Incorrect,1,Matcher,1,"T2",1093229,1096405,3176,Acoustic,1094242,1094837,595,"X"
D18_TT_Coded.eaf,D18,Visual,1,7,8,5,Incorrect,1,Matcher,1,"T2",1093229,1096405,3176,Acoustic,1095431,1096215,784,"X"
D18_TT_Coded.eaf,D18,Visual,1,7,8,5,Incorrect,2,Director,2,"T1",1096620,1110445,13825,Visual,1096620,1110445,13825,"X"
D18_TT_Coded.eaf,D18,Visual,1,8,6,6,Correct,1,Director,1,"T1",1115418,1127621,12203,Visual,1115418,1127621,12203,"X"
D18_TT_Coded.eaf,D18,Visual,1,8,6,6,Correct,2,Matcher,1,"T2",1128026,1130634,2608,Visual,1128026,1130634,2608,"X"
D18_TT_Coded.eaf,D18,Visual,1,9,2,2,Correct,2,Director,1,"T1",1135215,1137229,2014,Visual,1135215,1137229,2014,"X"
D18_TT_Coded.eaf,D18,Visual,1,9,2,2,Correct,2,Director,1,"T1",1135215,1137229,2014,Acoustic,1136040,1137243,1203,"X"
D18_TT_Coded.eaf,D18,Visual,1,10,4,4,Correct,1,Director,1,"T1",1139216,1141851,2635,Visual,1139216,1141851,2635,"X"
D18_TT_Coded.eaf,D18,Visual,1,10,4,4,Correct,1,Director,1,"T1",1139216,1141851,2635,Acoustic,1140431,1141621,1190,"X"
D18_TT_Coded.eaf,D18,Visual,1,11,7,7,Correct,2,Director,1,"T1",1146053,1154823,8770,Visual,1146053,1154823,8770,"X"
D18_TT_Coded.eaf,D18,Visual,1,12,8,8,Correct,1,Director,1,"T1",1157824,1165391,7567,Visual,1157824,1165391,7567,"X"
D18_TT_Coded.eaf,D18,Visual,1,12,8,8,Correct,1,Director,1,"T1",1157824,1165391,7567,Acoustic,1159216,1161608,2392,"X"
D18_TT_Coded.eaf,D18,Visual,1,12,8,8,Correct,1,Director,1,"T1",1157824,1165391,7567,Acoustic,1163026,1164836,1810,"X"
D18_TT_Coded.eaf,D18,Visual,1,13,6,6,Correct,2,Director,1,"T1",1169215,1172418,3203,Visual,1169215,1172418,3203,"X"
D18_TT_Coded.eaf,D18,Visual,1,13,6,6,Correct,2,Director,1,"T1",1169215,1172418,3203,Acoustic,1170810,1172228,1418,"X"
D18_TT_Coded.eaf,D18,Visual,1,13,6,6,Correct,1,Matcher,1,"T1",1173634,1176026,2392,Visual,1173634,1176026,2392,"X"
D18_TT_Coded.eaf,D18,Visual,1,14,1,1,Correct,1,Director,1,"T1",1173634,1176026,2392,Visual,1173634,1176026,2392,"X"
D18_TT_Coded.eaf,D18,Visual,1,15,5,5,Correct,2,Director,1,"T1",1178621,1182648,4027,Visual,1178621,1182648,4027,"X"
D18_TT_Coded.eaf,D18,Visual,2,0,7,7,Correct,1,Director,1,"T1",1187215,1192823,5608,Visual,1187215,1192823,5608,"X"
D18_TT_Coded.eaf,D18,Visual,2,0,7,7,Correct,2,Matcher,1,"T2",1192823,1193621,798,Visual,1192823,1193621,798,"X"
D18_TT_Coded.eaf,D18,Visual,2,0,7,7,Correct,2,Matcher,1,"T2",1192823,1193621,798,Acoustic,1193026,1193634,608,"X"
D18_TT_Coded.eaf,D18,Visual,2,0,7,7,Correct,1,Director,2,"T3",1193229,1198823,5594,Visual,1193235,1195816,2581,"X"
D18_TT_Coded.eaf,D18,Visual,2,0,7,7,Correct,1,Director,2,"T3",1193229,1198823,5594,Visual,1196842,1198829,1987,"X"
D18_TT_Coded.eaf,D18,Visual,2,1,1,1,Correct,2,Director,1,"T1",1201810,1203202,1392,Visual,1201810,1203202,1392,"X"
D18_TT_Coded.eaf,D18,Visual,2,2,3,3,Correct,1,Director,1,"T1",1205823,1207215,1392,Visual,1205823,1207215,1392,"X"
D18_TT_Coded.eaf,D18,Visual,2,3,8,5,Incorrect,2,Director,1,"T1",1211013,1215810,4797,Visual,1211013,1215810,4797,"X"
D18_TT_Coded.eaf,D18,Visual,2,3,8,5,Incorrect,1,Matcher,1,"T1",1217012,1222229,5217,Visual,1217012,1222229,5217,"X"
D18_TT_Coded.eaf,D18,Visual,2,4,5,7,Incorrect,1,Director,1,"T1",1217012,1222229,5217,Visual,1217012,1222229,5217,"X"
D18_TT_Coded.eaf,D18,Visual,2,4,5,7,Incorrect,2,Matcher,1,"T2",1224026,1225418,1392,Visual,1224026,1225418,1392,"X"
D18_TT_Coded.eaf,D18,Visual,2,4,5,7,Incorrect,2,Matcher,1,"T2",1224026,1225418,1392,Acoustic,1224810,1225431,621,"X"
D18_TT_Coded.eaf,D18,Visual,2,4,5,7,Incorrect,1,Director,2,"T3",1225418,1229418,4000,Visual,1225418,1229418,4000,"X"
D18_TT_Coded.eaf,D18,Visual,2,4,5,7,Incorrect,2,Matcher,2,"T4",1230215,1232228,2013,Acoustic,1230215,1232228,2013,"X"
D18_TT_Coded.eaf,D18,Visual,2,4,5,7,Incorrect,2,Matcher,2,"T4",1230215,1232228,2013,Visual,1230391,1232242,1851,"X"
D18_TT_Coded.eaf,D18,Visual,2,4,5,7,Incorrect,1,Director,3,"T5",1232256,1233229,973,Visual,1232256,1233229,973,"X"
D18_TT_Coded.eaf,D18,Visual,2,4,5,7,Incorrect,2,Matcher,3,"T5",1233229,1236620,3391,Acoustic,1233229,1233837,608,"X"
D18_TT_Coded.eaf,D18,Visual,2,4,5,7,Incorrect,2,Matcher,3,"T5",1233229,1236620,3391,Visual,1233229,1236620,3391,"X"
D18_TT_Coded.eaf,D18,Visual,2,4,5,7,Incorrect,2,Matcher,3,"T5",1233229,1236620,3391,Acoustic,1234216,1234608,392,"X"
D18_TT_Coded.eaf,D18,Visual,2,4,5,7,Incorrect,2,Matcher,3,"T5",1233229,1236620,3391,Acoustic,1234810,1235823,1013,"X"
D18_TT_Coded.eaf,D18,Visual,2,4,5,7,Incorrect,1,Director,4,"T6",1234823,1239405,4582,Visual,1234823,1239405,4582,"X"
D18_TT_Coded.eaf,D18,Visual,2,5,4,4,Correct,2,Director,1,"T1",1241621,1244418,2797,Visual,1241621,1244418,2797,"X"
D18_TT_Coded.eaf,D18,Visual,2,4,5,7,Incorrect,2,Matcher,4,"T1",1241621,1244418,2797,Visual,1241621,1244418,2797,"X"
D18_TT_Coded.eaf,D18,Visual,2,5,4,4,Correct,2,Director,1,"T1",1241621,1244418,2797,Acoustic,1242013,1242823,810,"X"
D18_TT_Coded.eaf,D18,Visual,2,4,5,7,Incorrect,2,Matcher,4,"T1",1241621,1244418,2797,Acoustic,1242013,1242823,810,"X"
D18_TT_Coded.eaf,D18,Visual,2,5,4,4,Correct,2,Director,1,"T1",1241621,1244418,2797,Acoustic,1243026,1244432,1406,"X"
D18_TT_Coded.eaf,D18,Visual,2,4,5,7,Incorrect,2,Matcher,4,"T1",1241621,1244418,2797,Acoustic,1243026,1244432,1406,"X"
D18_TT_Coded.eaf,D18,Visual,2,6,6,6,Correct,1,Director,1,"T1",1247823,1251621,3798,Visual,1247823,1251621,3798,"X"
D18_TT_Coded.eaf,D18,Visual,2,7,2,2,Correct,2,Director,1,"T1",1255620,1258026,2406,Visual,1255620,1258026,2406,"X"
D18_TT_Coded.eaf,D18,Visual,2,7,2,2,Correct,2,Director,1,"T1",1255620,1258026,2406,Acoustic,1255823,1257836,2013,"X"
D18_TT_Coded.eaf,D18,Visual,2,8,1,1,Correct,1,Director,1,"T1",1260215,1264026,3811,Visual,1260215,1264026,3811,"X"
D18_TT_Coded.eaf,D18,Visual,2,9,5,5,Correct,2,Director,1,"T1",1266620,1269728,3108,Visual,1266620,1269728,3108,"X"
D18_TT_Coded.eaf,D18,Visual,2,9,5,5,Correct,2,Director,1,"T1",1266620,1269728,3108,Acoustic,1267026,1267432,406,"X"
D18_TT_Coded.eaf,D18,Visual,2,9,5,5,Correct,2,Director,1,"T1",1266620,1269728,3108,Acoustic,1268418,1269621,1203,"X"
D18_TT_Coded.eaf,D18,Visual,2,10,2,2,Correct,1,Director,1,"T1",1273216,1275621,2405,Visual,1273216,1275621,2405,"X"
D18_TT_Coded.eaf,D18,Visual,2,11,3,3,Correct,2,Director,1,"T1",1277621,1279026,1405,Visual,1277621,1279026,1405,"X"
D18_TT_Coded.eaf,D18,Visual,2,12,8,8,Correct,1,Director,1,"T1",1281607,1288026,6419,Visual,1281607,1288026,6419,"X"
D18_TT_Coded.eaf,D18,Visual,2,13,6,6,Correct,2,Director,1,"T1",1288202,1291094,2892,Visual,1288202,1291094,2892,"X"
D18_TT_Coded.eaf,D18,Visual,2,12,8,8,Correct,2,Matcher,1,"T1",1288202,1291094,2892,Visual,1288202,1291094,2892,"X"
D18_TT_Coded.eaf,D18,Visual,2,14,4,4,Correct,1,Director,1,"T1",1293621,1295621,2000,Visual,1293621,1295621,2000,"X"
D18_TT_Coded.eaf,D18,Visual,2,14,4,4,Correct,1,Director,1,"T1",1293621,1295621,2000,Acoustic,1294418,1295229,811,"X"
D18_TT_Coded.eaf,D18,Visual,2,15,7,7,Correct,2,Director,1,"T1",1298635,1301621,2986,Visual,1298635,1301621,2986,"X"
D18_TT_Coded.eaf,D18,Visual,3,0,8,8,Correct,1,Director,1,"T1",1307810,1313608,5798,Visual,1307810,1313608,5798,"X"
D18_TT_Coded.eaf,D18,Visual,3,1,6,6,Correct,2,Director,1,"T1",1314621,1317621,3000,Visual,1314621,1317621,3000,"X"
D18_TT_Coded.eaf,D18,Visual,3,0,8,8,Correct,2,Matcher,1,"T1",1314621,1317621,3000,Visual,1314621,1317621,3000,"X"
D18_TT_Coded.eaf,D18,Visual,3,2,5,5,Correct,1,Director,1,"T1",1318823,1326026,7203,Visual,1318823,1326026,7203,"X"
D18_TT_Coded.eaf,D18,Visual,3,2,5,5,Correct,2,Matcher,1,"T2",1324013,1326621,2608,Acoustic,1324013,1324824,811,"X"
D18_TT_Coded.eaf,D18,Visual,3,2,5,5,Correct,2,Matcher,1,"T2",1324013,1326621,2608,Visual,1325432,1326634,1202,"X"
D18_TT_Coded.eaf,D18,Visual,3,2,5,5,Correct,1,Director,2,"T3",1326824,1328621,1797,Visual,1326824,1328621,1797,"X"
D18_TT_Coded.eaf,D18,Visual,3,2,5,5,Correct,2,Matcher,2,"T4",1328837,1332026,3189,Visual,1328837,1332026,3189,"X"
D18_TT_Coded.eaf,D18,Visual,3,2,5,5,Correct,2,Matcher,2,"T4",1328837,1332026,3189,Acoustic,1329432,1330040,608,"X"
D18_TT_Coded.eaf,D18,Visual,3,2,5,5,Correct,2,Matcher,2,"T4",1328837,1332026,3189,Acoustic,1330418,1331824,1406,"X"
D18_TT_Coded.eaf,D18,Visual,3,3,4,4,Correct,2,Director,1,"T1",1336188,1338620,2432,Visual,1336188,1338620,2432,"X"
D18_TT_Coded.eaf,D18,Visual,3,3,4,4,Correct,2,Director,1,"T1",1336188,1338620,2432,Acoustic,1336418,1338634,2216,"X"
D18_TT_Coded.eaf,D18,Visual,3,3,4,4,Correct,1,Matcher,1,"T1",1339418,1342026,2608,Visual,1339418,1342026,2608,"X"
D18_TT_Coded.eaf,D18,Visual,3,4,2,2,Correct,1,Director,1,"T1",1339418,1342026,2608,Visual,1339418,1342026,2608,"X"
D18_TT_Coded.eaf,D18,Visual,3,3,4,4,Correct,1,Matcher,1,"T1",1339418,1342026,2608,Acoustic,1339823,1341823,2000,"X"
D18_TT_Coded.eaf,D18,Visual,3,4,2,2,Correct,1,Director,1,"T1",1339418,1342026,2608,Acoustic,1339823,1341823,2000,"X"
D18_TT_Coded.eaf,D18,Visual,3,5,3,3,Correct,2,Director,1,"T1",1343621,1345026,1405,Visual,1343621,1345026,1405,"X"
D18_TT_Coded.eaf,D18,Visual,3,4,2,2,Correct,2,Matcher,1,"T1",1343621,1345026,1405,Visual,1343621,1345026,1405,"X"
D18_TT_Coded.eaf,D18,Visual,3,5,3,3,Correct,2,Director,1,"T1",1343621,1345026,1405,Acoustic,1344026,1344620,594,"X"
D18_TT_Coded.eaf,D18,Visual,3,4,2,2,Correct,2,Matcher,1,"T1",1343621,1345026,1405,Acoustic,1344026,1344620,594,"X"
D18_TT_Coded.eaf,D18,Visual,3,6,6,6,Correct,1,Director,1,"T1",1348026,1351553,3527,Visual,1348026,1351553,3527,"X"
D18_TT_Coded.eaf,D18,Visual,3,7,2,2,Correct,2,Director,1,"T1",1352824,1355026,2202,Visual,1352824,1355026,2202,"X"
D18_TT_Coded.eaf,D18,Visual,3,6,6,6,Correct,2,Matcher,1,"T1",1352824,1355026,2202,Visual,1352824,1355026,2202,"X"
D18_TT_Coded.eaf,D18,Visual,3,7,2,2,Correct,2,Director,1,"T1",1352824,1355026,2202,Acoustic,1353607,1354823,1216,"X"
D18_TT_Coded.eaf,D18,Visual,3,6,6,6,Correct,2,Matcher,1,"T1",1352824,1355026,2202,Acoustic,1353607,1354823,1216,"X"
D18_TT_Coded.eaf,D18,Visual,3,7,2,2,Correct,1,Matcher,1,"T1",1356608,1358310,1702,Visual,1356608,1358310,1702,"X"
D18_TT_Coded.eaf,D18,Visual,3,8,4,4,Correct,1,Director,1,"T1",1356608,1358310,1702,Visual,1356608,1358310,1702,"X"
D18_TT_Coded.eaf,D18,Visual,3,7,2,2,Correct,1,Matcher,1,"T1",1356608,1358310,1702,Acoustic,1357026,1358026,1000,"X"
D18_TT_Coded.eaf,D18,Visual,3,8,4,4,Correct,1,Director,1,"T1",1356608,1358310,1702,Acoustic,1357026,1358026,1000,"X"
D18_TT_Coded.eaf,D18,Visual,3,9,7,7,Correct,2,Director,1,"T1",1362607,1366418,3811,Visual,1362607,1366418,3811,"X"
D18_TT_Coded.eaf,D18,Visual,3,9,7,7,Correct,2,Director,1,"T1",1362607,1366418,3811,Acoustic,1363418,1364026,608,"X"
D18_TT_Coded.eaf,D18,Visual,3,9,7,7,Correct,2,Director,1,"T1",1362607,1366418,3811,Acoustic,1364823,1366229,1406,"X"
D18_TT_Coded.eaf,D18,Visual,3,9,7,7,Correct,1,Matcher,1,"T1",1367431,1368634,1203,Visual,1367431,1368634,1203,"X"
D18_TT_Coded.eaf,D18,Visual,3,10,3,3,Correct,1,Director,1,"T1",1367431,1368634,1203,Visual,1367431,1368634,1203,"X"
D18_TT_Coded.eaf,D18,Visual,3,9,7,7,Correct,1,Matcher,1,"T1",1367431,1368634,1203,Acoustic,1367822,1368228,406,"X"
D18_TT_Coded.eaf,D18,Visual,3,10,3,3,Correct,1,Director,1,"T1",1367431,1368634,1203,Acoustic,1367822,1368228,406,"X"
D18_TT_Coded.eaf,D18,Visual,3,11,8,8,Correct,2,Director,1,"T1",1373797,1376013,2216,Visual,1373797,1376013,2216,"X"
D18_TT_Coded.eaf,D18,Visual,3,11,8,8,Correct,2,Director,1,"T1",1373797,1376013,2216,Acoustic,1374026,1375418,1392,"X"
D18_TT_Coded.eaf,D18,Visual,3,11,8,8,Correct,1,Matcher,1,"T2",1378607,1380621,2014,Visual,1378607,1380621,2014,"X"
D18_TT_Coded.eaf,D18,Visual,3,11,8,8,Correct,1,Matcher,1,"T2",1378607,1380621,2014,Acoustic,1379012,1379229,217,"X"
D18_TT_Coded.eaf,D18,Visual,3,11,8,8,Correct,1,Matcher,1,"T2",1378607,1380621,2014,Acoustic,1379729,1380418,689,"X"
D18_TT_Coded.eaf,D18,Visual,3,11,8,8,Correct,2,Director,2,"T3",1383810,1393823,10013,Visual,1383810,1389026,5216,"X"
D18_TT_Coded.eaf,D18,Visual,3,11,8,8,Correct,2,Director,2,"T3",1383810,1393823,10013,Acoustic,1384418,1388621,4203,"X"
D18_TT_Coded.eaf,D18,Visual,3,11,8,8,Correct,2,Director,2,"T3",1383810,1393823,10013,Visual,1389621,1393837,4216,"X"
D18_TT_Coded.eaf,D18,Visual,3,11,8,8,Correct,2,Director,2,"T3",1383810,1393823,10013,Acoustic,1389634,1390026,392,"X"
D18_TT_Coded.eaf,D18,Visual,3,11,8,8,Correct,2,Director,2,"T3",1383810,1393823,10013,Acoustic,1392228,1393228,1000,"X"
D18_TT_Coded.eaf,D18,Visual,3,12,1,1,Correct,1,Director,1,"T1",1395620,1397228,1608,Visual,1395620,1397228,1608,"X"
D18_TT_Coded.eaf,D18,Visual,3,13,5,5,Correct,2,Director,1,"T1",1399418,1402823,3405,Acoustic,1399418,1402823,3405,"X"
D18_TT_Coded.eaf,D18,Visual,3,13,5,5,Correct,2,Director,1,"T1",1399418,1402823,3405,Visual,1399418,1402823,3405,"X"
D18_TT_Coded.eaf,D18,Visual,3,12,1,1,Correct,2,Matcher,1,"T1",1399418,1402823,3405,Acoustic,1399418,1402823,3405,"X"
D18_TT_Coded.eaf,D18,Visual,3,12,1,1,Correct,2,Matcher,1,"T1",1399418,1402823,3405,Visual,1399418,1402823,3405,"X"
D18_TT_Coded.eaf,D18,Visual,3,14,7,7,Correct,1,Director,1,"T1",1404823,1408620,3797,Visual,1404823,1408620,3797,"X"
D18_TT_Coded.eaf,D18,Visual,3,14,7,7,Correct,1,Director,1,"T1",1404823,1408620,3797,Acoustic,1406026,1408026,2000,"X"
D18_TT_Coded.eaf,D18,Visual,3,15,1,1,Correct,2,Director,1,"T1",1410823,1412026,1203,Visual,1410823,1412026,1203,"X"
D18_TT_Coded.eaf,D18,Visual,3,14,7,7,Correct,2,Matcher,1,"T1",1410823,1412026,1203,Visual,1410823,1412026,1203,"X"
D18_TT_Coded.eaf,D18,Visual,3,15,1,1,Correct,2,Director,1,"T1",1410823,1412026,1203,Acoustic,1411229,1411823,594,"X"
D18_TT_Coded.eaf,D18,Visual,3,14,7,7,Correct,2,Matcher,1,"T1",1410823,1412026,1203,Acoustic,1411229,1411823,594,"X"